..##.....#
..#.#..####
..#..#....#
..#...#...#
..#.@..#..#
..#.....#.#
..#..#.#..#
..#.##.#.##
..#......#
..#....##
########