...#.....#
..##...####
.#....##..#
##...#....#
#...@#.#..#
#....###..#
#....#....#
#...##.#.##
#.......##
#......##
########